I beg your pardon?

* * *

>w
Creature Testing Facility
You're in the Creature Testing Facility. You know that because there's a sign on the bottom that seems like it was ripped off. There's really nothing else rather than that the walls are made of spiderwebs (3x stronger than steel!) Care to go West? Curiousity could kill you. The Military Lab's Center is back east.

>w
West Room
You're in the West Room. It's a little hot in this room. Spiderwebs dyed in red are encasted along the walls. A gigantic creature stands before you. The Creature Testing Facility is West of you.

You can see KLAW and a teleporter here.

>x wall
You can't see any such thing.

* * *

>w
Creature Testing Facility
You're in the Creature Testing Facility. You know that because there's a sign on the bottom that seems like it was ripped off. There's really nothing else rather than that the walls are made of spiderwebs (3x stronger than steel!) Care to go West? Curiousity could kill you. The Military Lab's Center is back east.

>attack klaw
You can't see any such thing.

* * *

>west
Creature Testing Facility
You're in the Creature Testing Facility. You know that because there's a sign on the bottom that seems like it was ripped off. There's really nothing else rather than that the walls are made of spiderwebs (3x stronger than steel!) Care to go West? Curiousity could kill you. The Military Lab's Center is back east.

>enter alpha tank
You can't see any such thing.

>west
West Room
You're in the West Room. It's a little hot in this room. Spiderwebs dyed in red are encasted along the walls. A gigantic creature stands before you. The Creature Testing Facility is West of you.

You can see KLAW and a teleporter here.

>enter alpha tank
You can't see any such thing.

>east
Creature Testing Facility
You're in the Creature Testing Facility. You know that because there's a sign on the bottom that seems like it was ripped off. There's really nothing else rather than that the walls are made of spiderwebs (3x stronger than steel!) Care to go West? Curiousity could kill you. The Military Lab's Center is back east.

>east
Center of The Military Lab
You're in the center of the Military Lab. It's quite the large room. 50 meters by 50 meters, maybe? How trippy. You wonder what went on here. There's some blood stains along the floor, but nothing like a murder scene. Where should you go now? You may go in all four directions: N, S, W, and E.

You can see a S Door, Titanium Box (closed), a Green Light, an Ice Tongs and a Chemical Tray Belt here.

>east
Nuclear Machinery
You're in the Nuclear Machinery Room. You don't wanna touch anything. The room is very big and filled with vehicles in a color that is quite unusual. It's also quite cold in here. You hear the sound of an air conditioner from far away but it's still quite loud.

You can see a Table (on which is a S Key), an Alpha Tank and a Jeep here.

>enter alpha tank
Hold your horses.

>enter alpha tank
But you're already on the Alpha Tank.

* * *

>west
Creature Testing Facility
You're in the Creature Testing Facility. You know that because there's a sign on the bottom that seems like it was ripped off. There's really nothing else rather than that the walls are made of spiderwebs (3x stronger than steel!) Care to go West? Curiousity could kill you. The Military Lab's Center is back east.

>west
West Room
You're in the West Room. It's a little hot in this room. Spiderwebs dyed in red are encasted along the walls. A gigantic creature stands before you. The Creature Testing Facility is West of you.

You can see KLAW and a teleporter here.

>x creature
KLAW seems to want to kill you. Are you going to run or fight? You think he'll beat the crap out of you if you use your hands.

KLAW looks at you and roars. You're so intimidated, as he stands at a solid 15 feet. He has the skin of a T-Rex and limbs like a very athletic animal. He has the face of a ninja turtle. The claws on his fingers and feet are covered in blood. A lab suit is in his mouth. He has the teeth of a mammoth shark.

* * *

>west
West Room
You're in the West Room. It's a little hot in this room. Spiderwebs dyed in red are encasted along the walls. A gigantic creature stands before you. The Creature Testing Facility is West of you.

You can see KLAW and a teleporter here.

>attack klaw
KLAW screams and slashes you, and knocks you back and hitting your back against the wall of the room. You then notice that from the slash you begin to lose blood. He made a huge cut. The pain is so overwhelming you pass out. You pass out from so much loss of blood and eventually more blood spews out of you and you die.

    *** You have died ***

In that game you scored 0 out of a possible 0, in 3 turns.

Would you like to RESTART, RESTORE a saved game, QUIT or UNDO the last command?

* * *

>west
West Room
You're in the West Room. It's a little hot in this room. Spiderwebs dyed in red are encasted along the walls. A gigantic creature stands before you. The Creature Testing Facility is West of you.

You can see KLAW and a teleporter here.

>go in teleporter
You get onto the teleporter.

>go on teleporter
You can't see any such thing.

>x teleporter
A teleporter. There is a fingerprint scanner. This teleporter is your way out. Could some chemical fix up your fingers?

>go in teleporter
But you're already on the teleporter.

>get off teleporter
You get off the teleporter.

West Room
You're in the West Room. It's a little hot in this room. Spiderwebs dyed in red are encasted along the walls. A gigantic creature stands before you. The Creature Testing Facility is West of you.

You can see KLAW and a teleporter here.

* * *

>west
West Room
You're in the West Room. It's a little hot in this room. Spiderwebs dyed in red are encasted along the walls. A gigantic creature stands before you. The Creature Testing Facility is West of you.

You can see KLAW and a teleporter here.

>x teleporter
A teleporter stands before you. This teleporter is your way out. Could some chemical fix up your fingers? A platform and a fingerprint scanner is on the teleporter. Next to it says HUMANS ONLY.

>get on teleporter
You get onto the teleporter.

* * *

>west
West Room
You're in the West Room. It's a little hot in this room. Spiderwebs dyed in red are encasted along the walls. A gigantic creature stands before you. The Creature Testing Facility is West of you.

You can see KLAW and a teleporter here.

>get on teleporter
You get onto the teleporter.

* * *

>west
West Room
You're in the West Room. It's a little hot in this room. Spiderwebs dyed in red are encasted along the walls. A gigantic creature stands before you. The Creature Testing Facility is West of you.

You can see KLAW and a teleporter here.

>east
Creature Testing Facility
You're in the Creature Testing Facility. You know that because there's a sign on the bottom that seems like it was ripped off. There's really nothing else rather than that the walls are made of spiderwebs (3x stronger than steel!) Care to go West? Curiousity could kill you. The Military Lab's Center is back east.

* * *

>east
Nuclear Machinery
You're in the Nuclear Machinery Room. You don't wanna touch anything. The room is very big and filled with vehicles in a color that is quite unusual. It's also quite cold in here. You hear the sound of an air conditioner from far away but it's still quite loud.

You can see a Table (on which is a S Key), an Alpha Tank and a Jeep here.

>enter alpha tank
I said to hold your horses.

* * *

>south
(first opening the S Door)
It seems to be locked.

>get on s door
(first opening the S Door)
It seems to be locked.

>get on s door
(first opening the S Door)
It seems to be locked.

* * *

>south
(first opening the S Door)
It seems to be locked.

>open south door
I only understood you as far as wanting to open south.

>open s door
It seems to be locked.

* * *

>sit on door
(first opening the S Door)
It seems to be locked.

>sit on light
You get onto the Green Light.

* * *

>east
Nuclear Machinery
You're in the Nuclear Machinery Room. You don't wanna touch anything. The room is very big and filled with vehicles in a color that is quite unusual. It's also quite cold in here. You hear the sound of an air conditioner from far away but it's still quite loud.

You can see a Table (on which is a S Key), an Alpha Tank and a Jeep here.

>enter jeep
Slow down. You'll die.

* * *

>east
Nuclear Machinery
You're in the Nuclear Machinery Room. You don't wanna touch anything. The room is very big and filled with vehicles in a color that is quite unusual. It's also quite cold in here. You hear the sound of an air conditioner from far away but it's still quite loud.

You can see a Table (on which is a S Key), an Alpha Tank and a Jeep here.

>touch alpha tank
The Alpha Tank notices you as an alien and not a human. You get a vibe from it, warning you to stay away and stressing that.

>touch alpha tank
The Tank launches a nuclear forcefield and fires a bullet straight through you. In the afterlife you figure that they had a fingerprint scanner on those vehicles. As they say, no one is allowed on Area 51 unauthorized.

    *** You have died ***

In that game you scored 0 out of a possible 0, in 3 turns.

Would you like to RESTART, RESTORE a saved game, QUIT or UNDO the last command?

* * *

>enter alpha tank
Hold your horses.

>enter alpha tank
Hold your horses.

* * *

>touch s door
These doors feel so cold.

* * *

>wet
That's not a verb I recognise.

>west
Creature Testing Facility
You're in the Creature Testing Facility. You know that because there's a sign on the bottom that seems like it was ripped off. There's really nothing else rather than that the walls are made of spiderwebs (3x stronger than steel!) Care to go West? Curiousity could kill you. The Military Lab's Center is back east.

>take restored fingerprints
You can't see any such thing.