You wake up in the base of a military lab. Can't believe you're alive, huh? From a sign outside you realize you're in Area 51. You feel as if 4 small parts of your body has been extracted right out of you but you don't know what's happened. You don't know what's going on. But what you do know from science is that you need to replemish what you've lost and get the hell out of this base using chemicals because something about you is strange. Yeah, your fingerprints don't even look right. The sign outside Area 51 was already intimidating. Now you're in the base of the operation. The military will do anything to kill you. It seems that everybody's out and the security cameras are off… for now. No time to poop your pants. Get out of here. But, be VERY careful.

Inside Area 51
An Interactive Fiction by Eric Tam
Release 1 / Serial number 131018 / Inform 7 build 6G60 (I6/v6.32 lib 6/12N) SD

Center of The Military Lab
You're in the center of the Military Lab. It's quite the large room. 50 meters by 50 meters, maybe? How trippy. You wonder what went on here.  Where should you go now?

You may go in all four directions: N, S, W, and E.

You can see a S Door, a Titanium Box (closed), a beaker, a Green Light and a blood here.

>east
Nuclear Machinery
You're in the Nuclear Machinery Room. You don't want to touch anything because everything looks so intimidating and so big. Even when you whisper the room echoes your voice.. There sure aren't any weapons around this room. The room is very big and filled with vehicles in a color that is quite unusual. It's also quite cold in here. You hear the sound of an air conditioner from far away but it's still quite loud.

The Center of The Military lab is back west. Another room seems to be at the next east turn.

You can see Table (on which is a suitcase (closed)), an Alpha Tank and a Jeep here.

>open suicase
You can't see any such thing.

>open suitcase
You open the suitcase, revealing a S Key.

>take key
Taken.

>west
Center of The Military Lab
You're in the center of the Military Lab. It's quite the large room. 50 meters by 50 meters, maybe? How trippy. You wonder what went on here.  Where should you go now?

You may go in all four directions: N, S, W, and E.

You can see a S Door, a W Door, a Titanium Box (closed), a Green Light, an Ice Tongs, a Chemical Tray Belt and a blood here.

>south
(first opening the S Door)
It seems to be locked.

>unlock door
Which do you mean, the S Door or the W Door?

>s door
(with the S Key)
You unlock the S Door.

>south
(first opening the S Door)

Nuclear Weapons Room
Goodness. So many weapons. There's something on the table.

The Center of the Military Lab is back north. Another room seems to be further below.

You can see a S Door, an Uranium Rifle, an Uranium Grenade and a W Key here.

>take rifle
Taken.

>take grenade
Taken.

>north
Center of The Military Lab
You're in the center of the Military Lab. It's quite the large room. 50 meters by 50 meters, maybe? How trippy. You wonder what went on here.  Where should you go now?

You may go in all four directions: N, S, W, and E.

You can see a S Door, a W Door, a Titanium Box (closed), a Green Light, an Ice Tongs, a Chemical Tray Belt and a blood here.

>west
(first opening the W Door)
It seems to be locked.

>west
(first opening the W Door)
It seems to be locked.

>south
Nuclear Weapons Room
Goodness. So many weapons. There's something on the table.

The Center of the Military Lab is back north. Another room seems to be further below.

You can see a S Door and a W Key here.

>take key
(the W Key)
Taken.

>north
Center of The Military Lab
You're in the center of the Military Lab. It's quite the large room. 50 meters by 50 meters, maybe? How trippy. You wonder what went on here.  Where should you go now?

You may go in all four directions: N, S, W, and E.

You can see a S Door, a W Door, a Titanium Box (closed), a Green Light, an Ice Tongs, a Chemical Tray Belt and a blood here.

* * *

>west
(first opening the W Door)
It seems to be locked.

>unlock w door
What do you want to unlock the W Door with?

>w key
You unlock the W Door.

>west
(first opening the W Door)

Creature Testing facility
You're in the Creature Testing Facility. You only know that because the floor is labeled CREATURE TESTING FACILITY. But somehow this place is generally empty. There's really nothing else rather than that the walls are made of spiderwebs (3x stronger than steel) Whatever's up ahead is probably gonna be something dangerous.

The Military Lab's Center is back east. Another room seems to be at the next west turn.

You can see a W Door, a big amount of spiderwebs and a sign here.

>west
West Room
This room is quite the room indeed. It has such a high ceiling with walls made of durable lead (imagine how heavy that is).

The Creature Testing Facility is back north

You can see Lead, a teleporter and KLAW here.

* * *

>attack KLAW
You throw a grenade into the open mouth of KLAW. He chokes and explodes. The blue chemical is right there and you take it, as well as a key.

>inventory
You are carrying:
  a N key
  a Blue Chemical
  a W Key
  an Uranium Grenade
  an Uranium Rifle
  a S Key

>east
Creature Testing facility
You're in the Creature Testing Facility. You only know that because the floor is labeled CREATURE TESTING FACILITY. But somehow this place is generally empty. There's really nothing else rather than that the walls are made of spiderwebs (3x stronger than steel) Whatever's up ahead is probably gonna be something dangerous.

The Military Lab's Center is back east. Another room seems to be at the next west turn.

You can see a W Door, a big amount of spiderwebs and a sign here.

>east
Center of The Military Lab
You're in the center of the Military Lab. It's quite the large room. 50 meters by 50 meters, maybe? How trippy. You wonder what went on here.  Where should you go now?

You may go in all four directions: N, S, W, and E.

You can see a S Door, a W Door, a Titanium Box (closed), a Green Light, an Ice Tongs, a Chemical Tray Belt and a blood here.

>north
Glassware Room
This room is not very big. It's full of glass containers. The room is of a tinted blue.

The Center of The Military Lab is back south. Another room seems to be up ahead.

You can see a N Door, a blue light, a large number of glass containers, a Test Tube Rack and a Broken Glass here.

>north
(first opening the N Door)
It seems to be locked.

>unlock n door
What do you want to unlock the N Door with?

>n key
You unlock the N Door.

>north
(first opening the N Door)

North Room
You've reached the north room. It's covered with titanium walls in its 20 feet by 20 feet entirity. The floor is made out of rubber.

The Glassware Room is back south.

You can see a N Door, a Big Safe (closed) and an Ammo Box here.

>south
Glassware Room
This room is not very big. It's full of glass containers. The room is of a tinted blue.

The Center of The Military Lab is back south. Another room seems to be up ahead.

You can see a N Door, a blue light, a large number of glass containers, a Test Tube Rack and a Broken Glass here.

>south
Center of The Military Lab
You're in the center of the Military Lab. It's quite the large room. 50 meters by 50 meters, maybe? How trippy. You wonder what went on here.  Where should you go now?

You may go in all four directions: N, S, W, and E.

You can see a S Door, a W Door, a Titanium Box (closed), a Green Light, an Ice Tongs, a Chemical Tray Belt and a blood here.

>south
Nuclear Weapons Room
Goodness. So many weapons. There's something on the table.

The Center of the Military Lab is back north. Another room seems to be further below.

You can see a S Door here.

>south
South Room
You're in the South Room. You feel radiation emitting from small Alpha Ray Guns in the distance. You can't reach them, but you can sense them. You wonder why there aren't really any things around there. Just two chests standing there.

The Nuclear Weapons Room is back north.

You can see a Left Chest (closed) and a Right Chest (closed) here.

>open chest
Which do you mean, the Left Chest or the Right Chest?

>left chest
You open the Left Chest, revealing a Green Chemical.

>take chemical
(the Green Chemical)
You don't have anything to hold the chemical.

>inventory
You are carrying:
  a N key
  a Blue Chemical
  a W Key
  an Uranium Grenade
  an Uranium Rifle
  a S Key

>north
Nuclear Weapons Room
Goodness. So many weapons. There's something on the table.

The Center of the Military Lab is back north. Another room seems to be further below.

You can see a S Door here.

>north
Center of The Military Lab
You're in the center of the Military Lab. It's quite the large room. 50 meters by 50 meters, maybe? How trippy. You wonder what went on here.  Where should you go now?

You may go in all four directions: N, S, W, and E.

You can see a S Door, a W Door, a Titanium Box (closed), a Green Light, an Ice Tongs, a Chemical Tray Belt and a blood here.

>take belt
Taken.

>take ice tongs
Taken.

>south
Nuclear Weapons Room
Goodness. So many weapons. There's something on the table.

The Center of the Military Lab is back north. Another room seems to be further below.

You can see a S Door here.

>south
South Room
You're in the South Room. You feel radiation emitting from small Alpha Ray Guns in the distance. You can't reach them, but you can sense them. You wonder why there aren't really any things around there. Just two chests standing there.

The Nuclear Weapons Room is back north.

You can see a Left Chest (in which is a Green Chemical) and a Right Chest (closed) here.

>open chest
Which do you mean, the Left Chest or the Right Chest?

>left chest
That's already open.

* * *

>open suitcase
You open the suitcase, revealing a S Key.

* * *

>take key
Taken.

>west
Center of The Military Lab
You're in the center of the Military Lab. It's quite the large room. 50 meters by 50 meters, maybe? How trippy. You wonder what went on here.  Where should you go now?

You may go in all four directions: N, S, W, and E.

You can see a S Door, a Titanium Box (closed), a beaker, a Green Light and a blood here.

>south
(first opening the S Door)
It seems to be locked.

>unlock door
(with the S Key)
You unlock the S Door.

>south
(first opening the S Door)

Nuclear Weapons Room
Goodness. So many weapons. There's something on the table.

The Center of the Military Lab is back north. Another room seems to be further below.

You can see a S Door, an Uranium Rifle and an Uranium Grenade here.

>take gun
You take the Uranium Rifle. Hope you have the grenade.

>take bomb
You take the Uranium Grenade. Hopefully you have the Rifle as well.

>south
South Room
You're in the South Room. You feel radiation emitting from small Alpha Ray Guns in the distance. You can't reach them, but you can sense them. You wonder why there aren't really any things around there. Just two chests standing there.

The Nuclear Weapons Room is back north.

You can see a Left Chest (closed) and a Right Chest (closed) here.

* * *

>open chest
Which do you mean, the Left Chest or the Right Chest?

>left
You open the Left Chest, revealing a Green Chemical.

>take green
You now have the Green Chemical.

>open right
You open the Right Chest, revealing a Code 654 and a Code 532.

>take 654
Taken.

>take 532
Taken.

>north
Nuclear Weapons Room
Goodness. So many weapons. There's something on the table.

The Center of the Military Lab is back north. Another room seems to be further below.

You can see a S Door here.

>north
Center of The Military Lab
You're in the center of the Military Lab. It's quite the large room. 50 meters by 50 meters, maybe? How trippy. You wonder what went on here.  Where should you go now?

You may go in all four directions: N, S, W, and E.

You can see a S Door, a Titanium Box (closed), a beaker, a Green Light and a blood here.

>west
Creature Testing facility
You're in the Creature Testing Facility. You only know that because the floor is labeled CREATURE TESTING FACILITY. But somehow this place is generally empty. There's really nothing else rather than that the walls are made of spiderwebs (3x stronger than steel) Whatever's up ahead is probably gonna be something dangerous.

The Military Lab's Center is back east. Another room seems to be at the next west turn.

You can see a big amount of spiderwebs and a sign here.

>west
West Room
This room is quite the room indeed. It has such a high ceiling with walls made of durable lead (imagine how heavy that is).

The Creature Testing Facility is back east.

You can see Lead, a teleporter and KRAM here.

* * *

>attack KRAM
You fire a bullet of Uranium at KRAM right in his stomach. He gets hurt and his mouth is open. You throw a grenade into the open mouth of KRAM. He chokes and explodes. The blue chemical is right there and you take it, as well as a key. Check your inventory.

[Your score has just gone up by three points.]

>east
Creature Testing facility
You're in the Creature Testing Facility. You only know that because the floor is labeled CREATURE TESTING FACILITY. But somehow this place is generally empty. There's really nothing else rather than that the walls are made of spiderwebs (3x stronger than steel) Whatever's up ahead is probably gonna be something dangerous.

The Military Lab's Center is back east. Another room seems to be at the next west turn.

You can see a big amount of spiderwebs and a sign here.

>east
Center of The Military Lab
You're in the center of the Military Lab. It's quite the large room. 50 meters by 50 meters, maybe? How trippy. You wonder what went on here.  Where should you go now?

You may go in all four directions: N, S, W, and E.

You can see a S Door, a Titanium Box (closed), a beaker, a Green Light and a blood here.

>n
Glassware Room
This room is not very big. It's full of glass containers. The room is of a tinted blue.

The Center of The Military Lab is back south. Another room seems to be up ahead.

You can see a N Door, a blue light, a large number of glass containers, a Test Tube Rack and a Broken Glass here.

>n
(first opening the N Door)
It seems to be locked.

>unlock n door
What do you want to unlock the N Door with?

* * *

>north
(first opening the N Door)

North Room
You've reached the north room. It's covered with titanium walls in its 20 feet by 20 feet entirity. The floor is made out of rubber.

The Glassware Room is back south.

You can see a N Door, a Big Safe (closed) and an Ammo Box here.

>unlock big safe
What do you want to unlock the Big Safe with?

>code 654
You unlock the Big Safe.

>open safe
You open the Big Safe, revealing Red Chemical.

>take red
Taken.

>south
Glassware Room
This room is not very big. It's full of glass containers. The room is of a tinted blue.

The Center of The Military Lab is back south. Another room seems to be up ahead.

You can see a N Door, a blue light, a large number of glass containers, a Test Tube Rack and a Broken Glass here.

>south
Center of The Military Lab
You're in the center of the Military Lab. It's quite the large room. 50 meters by 50 meters, maybe? How trippy. You wonder what went on here.  Where should you go now?

You may go in all four directions: N, S, W, and E.

You can see a S Door, a Titanium Box (closed), a beaker, a Green Light and a blood here.

>east
Nuclear Machinery
You're in the Nuclear Machinery Room. You don't want to touch anything because everything looks so intimidating and so big. Even when you whisper the room echoes your voice.. There sure aren't any weapons around this room. The room is very big and filled with vehicles in a color that is quite unusual. It's also quite cold in here. You hear the sound of an air conditioner from far away but it's still quite loud.

The Center of The Military lab is back west. Another room seems to be at the next east turn.

You can see Table (on which is a suitcase (empty)), an Alpha Tank and a Jeep here.

>east
East Room
You're in the the East Room. It's colder than usual in here. There's smoke coming from what looks to be a robot. Yeah. There is a big robot holding the yellow chemical, which is what the smoke is coming out of. The walls of the East Room are made of aluminum! Interesting.

The Nuclear Machinery room is back west.

You can see Robot 899 here.

>give robot code 532
Robot 899 smiles and gives you a high five. She gives you the Yellow Chemical along with a special key.

>inventory
You are carrying:
  a T Key
  a yellow chemical
  Red Chemical
  a N key
  a Blue Chemical
  a Code 532
  a Code 654
  a Green Chemical
  an Uranium Grenade
  an Uranium Rifle
  a S Key

>west
Nuclear Machinery
You're in the Nuclear Machinery Room. You don't want to touch anything because everything looks so intimidating and so big. Even when you whisper the room echoes your voice.. There sure aren't any weapons around this room. The room is very big and filled with vehicles in a color that is quite unusual. It's also quite cold in here. You hear the sound of an air conditioner from far away but it's still quite loud.

The Center of The Military lab is back west. Another room seems to be at the next east turn.

You can see Table (on which is a suitcase (empty)), an Alpha Tank and a Jeep here.

>west
Center of The Military Lab
You're in the center of the Military Lab. It's quite the large room. 50 meters by 50 meters, maybe? How trippy. You wonder what went on here.  Where should you go now?

You may go in all four directions: N, S, W, and E.

You can see a S Door, a Titanium Box (closed), a beaker, a Green Light and a blood here.

>open box
It seems to be locked.

>unlock box with t key
You unlock the Titanium Box.

>open box
You open the Titanium Box, revealing an Injection Syringe.

>take syringe
Taken.

You hear cold, heavy footsteps approaching your way. Doesn't sound good.

>north
Glassware Room
This room is not very big. It's full of glass containers. The room is of a tinted blue.

The Center of The Military Lab is back south. Another room seems to be up ahead.

You can see a N Door, a blue light, a large number of glass containers, a Test Tube Rack and a Broken Glass here.

>combine red with blue
(the Blue Chemical)
You merge these chemicals into each other by pouring them into a glass. Check your inventory to see what you got.

>combine yellow with green
You merge these chemicals into each other by pouring them into a glass. Check your inventory to see what chemical you got.

>inventory
You are carrying:
  Beta Chemical
  Alpha Chemical
  an Injection Syringe
  a T Key
  a N key
  a Code 532
  a Code 654
  an Uranium Grenade
  an Uranium Rifle
  a S Key

>combine alpha with beta
You take the new Alpha Chemical and the new Beta Chemical. Taking a deep breath you pour them into the same container. An orange chemical emerges. Check your inventory to see what chemical you got.

>pour delta chemical into syringe
Your pour the final chemical into the syringe. You know what to do now, so you inject yourself with the syringe. You feel weird for a minute and drop the syringe. You accidentally step on it and it disappears. Your body's fingerprints restore back to normal.

>inventory
You are carrying:
  Restored Fingerprints
  a T Key
  a N key
  a Code 532
  a Code 654
  an Uranium Grenade
  an Uranium Rifle
  a S Key

>west
You can't go that way.

>south
Center of The Military Lab
You're in the center of the Military Lab. It's quite the large room. 50 meters by 50 meters, maybe? How trippy. You wonder what went on here.  Where should you go now?

You may go in all four directions: N, S, W, and E.

You can see a S Door, a Titanium Box (empty), a beaker, a Green Light and a blood here.

>west
Creature Testing facility
You're in the Creature Testing Facility. You only know that because the floor is labeled CREATURE TESTING FACILITY. But somehow this place is generally empty. There's really nothing else rather than that the walls are made of spiderwebs (3x stronger than steel) Whatever's up ahead is probably gonna be something dangerous.

The Military Lab's Center is back east. Another room seems to be at the next west turn.

You can see a big amount of spiderwebs and a sign here.

>west
West Room
This room is quite the room indeed. It has such a high ceiling with walls made of durable lead (imagine how heavy that is).

The Creature Testing Facility is back east.

You can see Lead and a teleporter here.

* * *

>a
That's not a verb I recognise.

>s
You can't go that way.

I beg your pardon?

>sd
That's not a verb I recognise.

I beg your pardon?

>s
You can't go that way.

>d
You can't go that way.

I beg your pardon?

I beg your pardon?

* * *

>s
You can't go that way.

>s
You can't go that way.

* * *

>west
Center of The Military Lab
You're in the center of the Military Lab. It's quite the large room. 50 meters by 50 meters, maybe? How trippy. You wonder what went on here.  Where should you go now?

You may go in all four directions: N, S, W, and E.

You can see a S Door, a Titanium Box (closed), a beaker, a Green Light and a blood here.

>unlock door
(with the S Key)
You unlock the S Door.

* * *

>south
South Room
You're in the South Room. You feel radiation emitting from small Alpha Ray Guns in the distance. You can't reach them, but you can sense them. You wonder why there aren't really any things around there. Just two chests standing there.

The Nuclear Weapons Room is back north.

You can see a Left Chest (closed) and a Right Chest (closed) here.

>open left
You open the Left Chest, revealing a Green Chemical.

>take green
You now have the Green Chemical.

* * *

>take 532
Taken.

>west
You can't go that way.

>north
Nuclear Weapons Room
Goodness. So many weapons. There's something on the table.

The Center of the Military Lab is back north. Another room seems to be further below.

You can see a S Door here.

* * *

>east
Creature Testing facility
You're in the Creature Testing Facility. You only know that because the floor is labeled CREATURE TESTING FACILITY. But somehow this place is generally empty. There's really nothing else rather than that the walls are made of spiderwebs (3x stronger than steel) Whatever's up ahead is probably gonna be something dangerous.

The Military Lab's Center is back east. Another room seems to be at the next west turn.

You can see a big amount of spiderwebs and a sign here.

>ast
That's not a verb I recognise.

>n
You can't go that way.

>east
Center of The Military Lab
You're in the center of the Military Lab. It's quite the large room. 50 meters by 50 meters, maybe? How trippy. You wonder what went on here.  Where should you go now?

You may go in all four directions: N, S, W, and E.

You can see a S Door, a Titanium Box (closed), a beaker, a Green Light and a blood here.

* * *

>n
(first opening the N Door)
It seems to be locked.

>unlock n door with n key
You unlock the N Door.

>north
(first opening the N Door)

North Room
You've reached the north room. It's covered with titanium walls in its 20 feet by 20 feet entirity. The floor is made out of rubber.

The Glassware Room is back south.

You can see a N Door, a Big Safe (closed) and an Ammo Box here.

* * *

>east
East Room
You're in the the East Room. It's colder than usual in here. There's smoke coming from what looks to be a robot. Yeah. There is a big robot holding the yellow chemical, which is what the smoke is coming out of. The walls of the East Room are made of aluminum! Interesting.

The Nuclear Machinery room is back west.

You can see Robot 899 here.

>x robor
You can't see any such thing.

>x robot
A Robot made of aluminum that is wearing a lab coat. Her body is like a human being's body.

You see a female looking robot with the number 899 on her forehead. She senses your presence and asks for a code.

>give code 532
(to Robot 899)
Robot 899 smiles and gives you a high five. She gives you the Yellow Chemical along with a special key.

>west
Nuclear Machinery
You're in the Nuclear Machinery Room. You don't want to touch anything because everything looks so intimidating and so big. Even when you whisper the room echoes your voice.. There sure aren't any weapons around this room. The room is very big and filled with vehicles in a color that is quite unusual. It's also quite cold in here. You hear the sound of an air conditioner from far away but it's still quite loud.

The Center of The Military lab is back west. Another room seems to be at the next east turn.

You can see Table (on which is a suitcase (empty)), an Alpha Tank and a Jeep here.

* * *

>west
Center of The Military Lab
You're in the center of the Military Lab. It's quite the large room. 50 meters by 50 meters, maybe? How trippy. You wonder what went on here.  Where should you go now?

You may go in all four directions: N, S, W, and E.

You can see a S Door, a Titanium Box (closed), a beaker, a Green Light and a blood here.

>take box
Taken.

>north
Glassware Room
This room is not very big. It's full of glass containers. The room is of a tinted blue.

The Center of The Military Lab is back south. Another room seems to be up ahead.

You can see a N Door, a blue light, a large number of glass containers, a Test Tube Rack and a Broken Glass here.

* * *

>combine red with blue
(the Blue Chemical)
You merge these chemicals into each other by pouring them into a glass. Check your inventory to see what you got.

>combine green with yellow
You merge these chemicals into each other by pouring them into a glass. Check your inventory to see what chemical you got.

>combine alpha with beta
You take the new Alpha Chemical and the new Beta Chemical. Taking a deep breath you pour them into the same container. An orange chemical emerges. Check your inventory to see what chemical you got.

>unlock titanium box
What do you want to unlock the Titanium Box with?

>t key
You unlock the Titanium Box.

>open box
You open the Titanium Box, revealing an Injection Syringe.

>take syringe
Taken.

>pour delta chemical into syringe
Your pour the final chemical into the syringe. You know what to do now, so you inject yourself with the syringe. You feel weird for a minute and drop the syringe. You accidentally step on it and it disappears. Your body's fingerprints restore back to normal.

>west
You can't go that way.

>south
Center of The Military Lab
You're in the center of the Military Lab. It's quite the large room. 50 meters by 50 meters, maybe? How trippy. You wonder what went on here.  Where should you go now?

You may go in all four directions: N, S, W, and E.

You can see a S Door, a beaker, a Green Light and a blood here.

>west
Creature Testing facility
You're in the Creature Testing Facility. You only know that because the floor is labeled CREATURE TESTING FACILITY. But somehow this place is generally empty. There's really nothing else rather than that the walls are made of spiderwebs (3x stronger than steel) Whatever's up ahead is probably gonna be something dangerous.

The Military Lab's Center is back east. Another room seems to be at the next west turn.

You can see a big amount of spiderwebs and a sign here.

* * *

>enter teleporter
You put your fingerprints into the teleporter's finger scanner and the teleporter identifies you as a human. You go into the teleporter and you're taken outside to the NO TRESSPASSING OR GET SHOT sign. Victory!

    *** You have won ***

In that game you scored 3 out of a possible 10, in 54 turns.

Would you like to RESTART, RESTORE a saved game, QUIT or UNDO the last command?

* * *

>inventory
You are carrying nothing.

* * *

>w
(first opening the W Door)
It seems to be locked.

>s
(first opening the S Door)
It seems to be locked.

>east
Nuclear Machinery
You're in the Nuclear Machinery Room. You don't wanna touch anything because everything looks so intimidating and so big. Even when you whisper the room echoes your voice.. There sure aren't any weapons around this room. The room is very big and filled with vehicles in a color that is quite unusual. It's also quite cold in here. You hear the sound of an air conditioner from far away but it's still quite loud.

The Center of The Military lab is back west. Another room seems to be at the next east turn.

You can see an E Door, a Table (on which is a S Key), an Alpha Tank and a Jeep here.

>north
You can't go that way.

>north
You can't go that way.

>westr
That's not a verb I recognise.

>west
Center of The Military Lab
You're in the center of the Military Lab. It's quite the large room. 50 meters by 50 meters, maybe? How trippy. You wonder what went on here.  Where should you go now?

You may go in all four directions: N, S, W, and E.

You can see a S Door, a W Door, a Titanium Box (closed), a Green Light, an Ice Tongs, a Chemical Tray Belt and a blood here.

>north
Glassware Room
This room is not very big. It's full of glass containers. The room is of a tinted blue.

The Center of The Military Lab is back south. Another room seems to be up ahead.

You can see a N Door, a blue light, a large number of glass containers, a Test Tube Rack and a Broken Glass here.

* * *

>north
(first opening the N Door)
It seems to be locked.

>south
Center of The Military Lab
You're in the center of the Military Lab. It's quite the large room. 50 meters by 50 meters, maybe? How trippy. You wonder what went on here.  Where should you go now?

You may go in all four directions: N, S, W, and E.

You can see a S Door, a W Door, a Titanium Box (closed), a Green Light, an Ice Tongs, a Chemical Tray Belt and a blood here.

>south
(first opening the S Door)
It seems to be locked.

>east
Nuclear Machinery
You're in the Nuclear Machinery Room. You don't wanna touch anything because everything looks so intimidating and so big. Even when you whisper the room echoes your voice.. There sure aren't any weapons around this room. The room is very big and filled with vehicles in a color that is quite unusual. It's also quite cold in here. You hear the sound of an air conditioner from far away but it's still quite loud.

The Center of The Military lab is back west. Another room seems to be at the next east turn.

You can see an E Door, a Table (on which is a S Key), an Alpha Tank and a Jeep here.

* * *

>west
Creature Testing facility
You're in the Creature Testing Facility. You only know that because the floor is labeled CREATURE TESTING FACILITY. But somehow this place is generally empty. There's really nothing else rather than that the walls are made of spiderwebs (3x stronger than steel) Whatever's up ahead is probably gonna be something dangerous.

The Military Lab's Center is back east. Another room seems to be at the next west turn.

You can see a big amount of spiderwebs and a sign here.

>est
That's not a verb I recognise.

>west
West Room
This room is quite the room indeed. It has such a high ceiling with walls made of durable lead (imagine how heavy that is).

You can see Lead, a teleporter and KLAW here.

>east
Creature Testing facility
You're in the Creature Testing Facility. You know that because there's a sign on the bottom that seems like it was ripped off. There's really nothing else rather than that the walls are made of spiderwebs (3x stronger than steel!) Care to go West? Curiousity could kill you.

The Military Lab's Center is back east.

You can see a big amount of spiderwebs and a sign here.

>east
Center of The Military Lab
You're in the center of the Military Lab. It's quite the large room. 50 meters by 50 meters, maybe? How trippy. You wonder what went on here.  Where should you go now?

You may go in all four directions: N, S, W, and E.

You can see a S Door, a Titanium Box (closed), a Green Light, an Ice Tongs, a Chemical Tray Belt and a blood here.

>east
Nuclear Machinery
You're in the Nuclear Machinery Room. You don't wanna touch anything because everything looks so intimidating and so big. Even when you whisper the room echoes your voice.. There sure aren't any weapons around this room. The room is very big and filled with vehicles in a color that is quite unusual. It's also quite cold in here. You hear the sound of an air conditioner from far away but it's still quite loud.

You can see an E Door, a Table (on which is a S Key), an Alpha Tank and a Jeep here.

>x table
A table that seems like you CAN touch.

On the Table is a S Key.

>x e door
Another titanium door. This place is so metallic.

A key lock is on the door.

>x alpha tank
It's a large tank. It's larger than most, you think. The wheels are as big as monster truck wheels and the gun is like the length of a small car. There are no warning labels. Best not to touch it. Most likely you're bound to die.

>x jeep
A jeep. What? It has two turrets in the front and back that says TRIDIUM BULLETS INSIDE. You wouldn't have the guts to even touch that vehicle. You shouldn't be the one to die here.

* * *

>west
Creature Testing facility
You're in the Creature Testing Facility. You only know that because the floor is labeled CREATURE TESTING FACILITY. But somehow this place is generally empty. There's really nothing else rather than that the walls are made of spiderwebs (3x stronger than steel) Whatever's up ahead is probably gonna be something dangerous.

The Military Lab's Center is back east. Another room seems to be at the next west turn.

You can see a big amount of spiderwebs and a sign here.

>x webs
You can't see any such thing.

>x spiderwebs
We've been told spiderwebs could be manipulated for sturdy use. Nice job, Area 51. You've encasted the walls in spiderwebs.

>east
Center of The Military Lab
You're in the center of the Military Lab. It's quite the large room. 50 meters by 50 meters, maybe? How trippy. You wonder what went on here.  Where should you go now?

You may go in all four directions: N, S, W, and E.

You can see a S Door, a Titanium Box (closed), a beaker, a Green Light and a blood here.

>ast
That's not a verb I recognise.

>east
Nuclear Machinery
You're in the Nuclear Machinery Room. You don't want to touch anything because everything looks so intimidating and so big. Even when you whisper the room echoes your voice.. There sure aren't any weapons around this room. The room is very big and filled with vehicles in a color that is quite unusual. It's also quite cold in here. You hear the sound of an air conditioner from far away but it's still quite loud.

The Center of The Military lab is back west. Another room seems to be at the next east turn.

You can see Table (on which is a suitcase (closed)), an Alpha Tank and a Jeep here.

>e
East Room
You're in the the East Room. It's colder than usual in here. There's smoke coming from what looks to be a robot. Yeah. There is a big robot holding the yellow chemical, which is what the smoke is coming out of. The walls of the East Room are made of aluminum! Interesting.

The Nuclear Machinery room is back west.

You can see Robot 899 here.

>w
Nuclear Machinery
You're in the Nuclear Machinery Room. You don't want to touch anything because everything looks so intimidating and so big. Even when you whisper the room echoes your voice.. There sure aren't any weapons around this room. The room is very big and filled with vehicles in a color that is quite unusual. It's also quite cold in here. You hear the sound of an air conditioner from far away but it's still quite loud.

The Center of The Military lab is back west. Another room seems to be at the next east turn.

You can see Table (on which is a suitcase (closed)), an Alpha Tank and a Jeep here.

>open suitcase
You open the suitcase, revealing a S Key.

* * *

>open left
You open the Left Chest, revealing a Green Chemical.

>take g
You can't see any such thing.

>take green
You now have the Green Chemical.

* * *

>north
Center of The Military Lab
You're in the center of the Military Lab. It's quite the large room. 50 meters by 50 meters, maybe? How trippy. You wonder what went on here.  Where should you go now?

You may go in all four directions: N, S, W, and E.

You can see a S Door, a Titanium Box (closed), a beaker, a Green Light and a blood here.

>north
Glassware Room
This room is not very big. It's full of glass containers. The room is of a tinted blue.

The Center of The Military Lab is back south. Another room seems to be up ahead.

You can see a N Door, a blue light, a large number of glass containers, a Test Tube Rack and a Broken Glass here.

>south
Center of The Military Lab
You're in the center of the Military Lab. It's quite the large room. 50 meters by 50 meters, maybe? How trippy. You wonder what went on here.  Where should you go now?

You may go in all four directions: N, S, W, and E.

You can see a S Door, a Titanium Box (closed), a beaker, a Green Light and a blood here.

>w
Creature Testing facility
You're in the Creature Testing Facility. You only know that because the floor is labeled CREATURE TESTING FACILITY. But somehow this place is generally empty. There's really nothing else rather than that the walls are made of spiderwebs (3x stronger than steel) Whatever's up ahead is probably gonna be something dangerous.

The Military Lab's Center is back east. Another room seems to be at the next west turn.

You can see a big amount of spiderwebs and a sign here.

>w
West Room
This room is quite the room indeed. It has such a high ceiling with walls made of durable lead (imagine how heavy that is).

The Creature Testing Facility is back east.

You can see Lead, a teleporter and KRAM here.

* * *

>attack KRAM
You fire a bullet of Uranium at KRAM right in his stomach. He gets hurt and his mouth is open. You throw a grenade into the open mouth of KRAM. He chokes and explodes. The blue chemical is right there and you take it, as well as a key. Check your inventory.

[Your score has just gone up by three points.]

>inventory
You are carrying:
  a N key
  a Blue Chemical
  a Code 532
  a Code 654
  a Green Chemical
  an Uranium Grenade
  an Uranium Rifle
  a S Key

>east
Creature Testing facility
You're in the Creature Testing Facility. You only know that because the floor is labeled CREATURE TESTING FACILITY. But somehow this place is generally empty. There's really nothing else rather than that the walls are made of spiderwebs (3x stronger than steel) Whatever's up ahead is probably gonna be something dangerous.

The Military Lab's Center is back east. Another room seems to be at the next west turn.

You can see a big amount of spiderwebs and a sign here.

* * *

>east
Center of The Military Lab
You're in the center of the Military Lab. It's quite the large room. 50 meters by 50 meters, maybe? How trippy. You wonder what went on here.  Where should you go now?

You may go in all four directions: N, S, W, and E.

You can see a S Door, a Titanium Box (closed), a beaker, a Green Light and a blood here.

>north
Glassware Room
This room is not very big. It's full of glass containers. The room is of a tinted blue.

The Center of The Military Lab is back south. Another room seems to be up ahead.

You can see a N Door, a blue light, a large number of glass containers, a Test Tube Rack and a Broken Glass here.

* * *

>take red
Taken.

>sotuh
That's not a verb I recognise.

>south
Glassware Room
This room is not very big. It's full of glass containers. The room is of a tinted blue.

The Center of The Military Lab is back south. Another room seems to be up ahead.

You can see a N Door, a blue light, a large number of glass containers, a Test Tube Rack and a Broken Glass here.

* * *

>south
Center of The Military Lab
You're in the center of the Military Lab. It's quite the large room. 50 meters by 50 meters, maybe? How trippy. You wonder what went on here.  Where should you go now?

You may go in all four directions: N, S, W, and E.

You can see a S Door, a Titanium Box (closed), a beaker, a Green Light and a blood here.

>take box
Taken.

>east
Nuclear Machinery
You're in the Nuclear Machinery Room. You don't want to touch anything because everything looks so intimidating and so big. Even when you whisper the room echoes your voice.. There sure aren't any weapons around this room. The room is very big and filled with vehicles in a color that is quite unusual. It's also quite cold in here. You hear the sound of an air conditioner from far away but it's still quite loud.

The Center of The Military lab is back west. Another room seems to be at the next east turn.

You can see Table (on which is a suitcase (empty)), an Alpha Tank and a Jeep here.

* * *

>east
East Room
You're in the the East Room. It's colder than usual in here. There's smoke coming from what looks to be a robot. Yeah. There is a big robot holding the yellow chemical, which is what the smoke is coming out of. The walls of the East Room are made of aluminum! Interesting.

The Nuclear Machinery room is back west.

You can see Robot 899 here.

>give robor code 532
You can't see any such thing.

>give robot code 532
Robot 899 smiles and gives you a high five. She gives you the Yellow Chemical along with a special key.

>inventory
You are carrying:
  a T Key
  a yellow chemical
  a Titanium Box (closed and locked)
  Red Chemical
  a N key
  a Blue Chemical
  a Code 532
  a Code 654
  a Green Chemical
  an Uranium Grenade
  an Uranium Rifle
  a S Key

>unlock titanium box with t key
You unlock the Titanium Box.

>open box
You open the Titanium Box, revealing an Injection Syringe.

* * *

>take syringe
Taken.

>x syringe
A syringe used for injections. It's the size of a hot glue gun.

>combine red with blue
You merge these chemicals into each other by pouring them into a glass. Check your inventory to see what you got.

>combine green with yellow
You merge these chemicals into each other by pouring them into a glass. Check your inventory to see what chemical you got.

* * *

>combine alpha with beta
You take the new Alpha Chemical and the new Beta Chemical. Taking a deep breath you pour them into the same container. An orange chemical emerges. Check your inventory to see what chemical you got.

>put delta into syringe
You put Delta Chemical into the Injection Syringe.

>put delta on injection syringe
You put the brightly orange chemical into the syringe. It's now ready for injection. You inject yourself with the Delta Chemical. You suddenly feel a little more humane and your fingerprints are restored.

>invrentory
That's not a verb I recognise.

>inventory
You are carrying:
  Restored Fingerprints
  a T Key
  a Titanium Box (open but empty)
  a N key
  a Code 532
  a Code 654
  an Uranium Grenade
  an Uranium Rifle
  a S Key

>west
Nuclear Machinery
You're in the Nuclear Machinery Room. You don't want to touch anything because everything looks so intimidating and so big. Even when you whisper the room echoes your voice.. There sure aren't any weapons around this room. The room is very big and filled with vehicles in a color that is quite unusual. It's also quite cold in here. You hear the sound of an air conditioner from far away but it's still quite loud.

The Center of The Military lab is back west. Another room seems to be at the next east turn.

You can see Table (on which is a suitcase (empty)), an Alpha Tank and a Jeep here.

>west
Center of The Military Lab
You're in the center of the Military Lab. It's quite the large room. 50 meters by 50 meters, maybe? How trippy. You wonder what went on here.  Where should you go now?

You may go in all four directions: N, S, W, and E.

You can see a S Door, a beaker, a Green Light and a blood here.

>west
Creature Testing facility
You're in the Creature Testing Facility. You only know that because the floor is labeled CREATURE TESTING FACILITY. But somehow this place is generally empty. There's really nothing else rather than that the walls are made of spiderwebs (3x stronger than steel) Whatever's up ahead is probably gonna be something dangerous.

The Military Lab's Center is back east. Another room seems to be at the next west turn.

You can see a big amount of spiderwebs and a sign here.

* * *

>west
West Room
This room is quite the room indeed. It has such a high ceiling with walls made of durable lead (imagine how heavy that is).

The Creature Testing Facility is back east.

You can see Lead and a teleporter here.

>x teleporter
You put your fingerprints into the teleporter's finger scanner and the teleporter identifies you as a human. You go into the teleporter and you're taken outside to the NO TRESSPASSING OR GET SHOT sign. Victory!

    *** You have won ***

In that game you scored 3 out of a possible 10, in 60 turns.

Would you like to RESTART, RESTORE a saved game, QUIT or UNDO the last command?

* * *

>west
Creature Testing facility
You're in the Creature Testing Facility. You only know that because the floor is labeled CREATURE TESTING FACILITY. But somehow this place is generally empty. There's really nothing else rather than that the walls are made of spiderwebs (3x stronger than steel) Whatever's up ahead is probably gonna be something dangerous.

The Military Lab's Center is back east. Another room seems to be at the next west turn.

You can see a big amount of spiderwebs and a sign here.

>take sign
You take the small sign. At least you have a souvenir now!

[Your score has just gone up by three points.]

>east
Center of The Military Lab
You're in the center of the Military Lab. It's quite the large room. 50 meters by 50 meters, maybe? How trippy. You wonder what went on here.  Where should you go now?

You may go in all four directions: N, S, W, and E.

You can see a S Door, a Titanium Box (closed), a beaker, a Green Light and a blood here.

>west
Creature Testing facility
You're in the Creature Testing Facility. You only know that because the floor is labeled CREATURE TESTING FACILITY. But somehow this place is generally empty. There's really nothing else rather than that the walls are made of spiderwebs (3x stronger than steel) Whatever's up ahead is probably gonna be something dangerous.

The Military Lab's Center is back east. Another room seems to be at the next west turn.

You can see a big amount of spiderwebs and a sign here.

>west
West Room
This room is quite the room indeed. It has such a high ceiling with walls made of durable lead (imagine how heavy that is).

The Creature Testing Facility is back north

You can see Lead, a teleporter and KLAW here.

>attack KLAW
You attempt to charge at KLAW and the creature takes notice at you. Being aggressive as he is, KLAW raises his claw and stabs you straight through your stomach. Shoot.

    *** You have died ***

In that game you scored 3 out of a possible 0, in 6 turns.

Would you like to RESTART, RESTORE a saved game, QUIT or UNDO the last command?

* * *

>west
Creature Testing facility
You're in the Creature Testing Facility. You only know that because the floor is labeled CREATURE TESTING FACILITY. But somehow this place is generally empty. There's really nothing else rather than that the walls are made of spiderwebs (3x stronger than steel) Whatever's up ahead is probably gonna be something dangerous.

The Military Lab's Center is back east. Another room seems to be at the next west turn.

You can see a big amount of spiderwebs and a sign here.

>east
Center of The Military Lab
You're in the center of the Military Lab. It's quite the large room. 50 meters by 50 meters, maybe? How trippy. You wonder what went on here.  Where should you go now?

You may go in all four directions: N, S, W, and E.

You can see a S Door, a Titanium Box (closed), a beaker, a Green Light and a blood here.

>open suitcase
You open the suitcase, revealing a S Key.

>north
You can't go that way.

>take key
Taken.

>west
Center of The Military Lab
You're in the center of the Military Lab. It's quite the large room. 50 meters by 50 meters, maybe? How trippy. You wonder what went on here.  Where should you go now?

You may go in all four directions: N, S, W, and E.

You can see a S Door, a W Door, a Titanium Box (closed), a beaker, a Green Light and a blood here.

>south
(first opening the S Door)
It seems to be locked.

>unlock s door
(with the S Key)
You unlock the S Door.

>south
(first opening the S Door)

Nuclear Weapons Room
Goodness. So many weapons. There's something on the table.

The Center of the Military Lab is back north. Another room seems to be further below.

You can see a S Door, an Uranium Rifle, an Uranium Grenade and a W Key here.

>take w key
Taken.

>take rifle
Taken.

* * *

>take grenade
Taken.

>north
Center of The Military Lab
You're in the center of the Military Lab. It's quite the large room. 50 meters by 50 meters, maybe? How trippy. You wonder what went on here.  Where should you go now?

You may go in all four directions: N, S, W, and E.

You can see a S Door, a W Door, a Titanium Box (closed), a beaker, a Green Light and a blood here.

>west
(first opening the W Door)
It seems to be locked.

* * *

>attack KLAW
You fire a bullet of Uranium at KLAW right in his stomach. He gets hurt and his mouth is open. You throw a grenade into the open mouth of KLAW. He chokes and explodes. The blue chemical is right there and you take it, as well as a key.

* * *

>east
Center of The Military Lab
You're in the center of the Military Lab. It's quite the large room. 50 meters by 50 meters, maybe? How trippy. You wonder what went on here.  Where should you go now?

You may go in all four directions: N, S, W, and E.

You can see a S Door, a Titanium Box (closed), a beaker, a Green Light and a blood here.

>east
Nuclear Machinery
You're in the Nuclear Machinery Room. You don't wanna touch anything because everything looks so intimidating and so big. Even when you whisper the room echoes your voice.. There sure aren't any weapons around this room. The room is very big and filled with vehicles in a color that is quite unusual. It's also quite cold in here. You hear the sound of an air conditioner from far away but it's still quite loud.

The Center of The Military lab is back west. Another room seems to be at the next east turn.

You can see an E Door, Table (on which is a suitcase (closed)), an Alpha Tank and a Jeep here.

>open suitcase
You open the suitcase, revealing a S Key.

* * *

>take key
Taken.

>east
(first opening the E Door)
It seems to be locked.

>west
Center of The Military Lab
You're in the center of the Military Lab. It's quite the large room. 50 meters by 50 meters, maybe? How trippy. You wonder what went on here.  Where should you go now?

You may go in all four directions: N, S, W, and E.

You can see a S Door, a Titanium Box (closed), a beaker, a Green Light and a blood here.

>west
Creature Testing facility
You're in the Creature Testing Facility. You only know that because the floor is labeled CREATURE TESTING FACILITY. But somehow this place is generally empty. There's really nothing else rather than that the walls are made of spiderwebs (3x stronger than steel) Whatever's up ahead is probably gonna be something dangerous.

The Military Lab's Center is back east. Another room seems to be at the next west turn.

You can see a big amount of spiderwebs and a sign here.

>south
You can't go that way.

>east
Center of The Military Lab
You're in the center of the Military Lab. It's quite the large room. 50 meters by 50 meters, maybe? How trippy. You wonder what went on here.  Where should you go now?

You may go in all four directions: N, S, W, and E.

You can see a S Door, a Titanium Box (closed), a beaker, a Green Light and a blood here.

>south
(first opening the S Door)
It seems to be locked.

* * *

>south
(first opening the S Door)

Nuclear Weapons Room
Goodness. So many weapons. There's something on the table.

The Center of the Military Lab is back north. Another room seems to be further below.

You can see a S Door, an Uranium Rifle and an Uranium Grenade here.

>take rifle
You take the Uranium Rifle. Better have the grenade too, just in case.

>take grenade
You take the Uranium Grenade. Better have the rifle too, just in case.

* * *

>west
Center of The Military Lab
You're in the center of the Military Lab. It's quite the large room. 50 meters by 50 meters, maybe? How trippy. You wonder what went on here.  Where should you go now?

You may go in all four directions: N, S, W, and E.

You can see a S Door, a Titanium Box (closed), a beaker, a Green Light and a blood here.

>down
You can't go that way.

>south
(first opening the S Door)
It seems to be locked.

* * *

>unlock s door
(with the S Key)
You unlock the S Door.

>south
(first opening the S Door)

Nuclear Weapons Room
Goodness. So many weapons. There's something on the table.

The Center of the Military Lab is back north. Another room seems to be further below.

You can see a S Door, an Uranium Rifle and an Uranium Grenade here.

>south
South Room
You're in the South Room. You feel radiation emitting from small Alpha Ray Guns in the distance. You can't reach them, but you can sense them. You wonder why there aren't really any things around there. Just two chests standing there.

The Nuclear Weapons Room is back north.

You can see a Left Chest (closed) and a Right Chest (closed) here.

>open left chest
You open the Left Chest, revealing a Green Chemical.

>take green chemical
You take the Green Chemical and put it in your belt with the tray on it to store the chemicals.

* * *

>west
West Room
This room is quite the room indeed. It has such a high ceiling with walls made of durable lead (imagine how heavy that is).

The Creature Testing Facility is back east.

You can see Lead, a teleporter and KRAM here.

>x teleporter
A teleporter. You know it's a teleporter because of how it looks: with a giant platform in the middle. There's a fingerprint scanner on it and near it it's labeled HUMANS ONLY. You'd better restore your fingerprints to get out of this place and pass the game.

>take teleporter
You can't take that with you. Foolish child.

>x KLAW
KLAW seems to want to kill you. Are you going to run or fight? You think he'll beat the crap out of you if you use your hands. You mind as well grab some kind of chemical weapon.

KLAW looks at you and roars. You're so intimidated, as he stands at a solid 15 feet. He has the skin of a T-Rex and limbs like a very athletic animal. He has the face of a ninja turtle. The claws on his fingers and feet are covered in blood. A lab suit is in his mouth. He has the teeth of a mammoth shark.

>attack KLAW
KLAW raises his claw and stabs you straight through your stomach. Shoot.

    *** You have died ***

In that game you scored 0 out of a possible 0, in 6 turns.

Would you like to RESTART, RESTORE a saved game, QUIT or UNDO the last command?

* * *

>x teleporter
A teleporter. You know it's a teleporter because of how it looks: with a giant platform in the middle. There's a fingerprint scanner on it and near it it's labeled HUMANS ONLY. You'd better restore your fingerprints to get out of this place and pass the game.

>inventory
You are carrying nothing.

* * *

>west
West Room
This room is quite the room indeed. It has such a high ceiling with walls made of durable lead (imagine how heavy that is).

The Creature Testing Facility is back east.

You can see Lead, a teleporter and KRAM here.

>attack KLAW
You attempt to charge at KLAW and the creature takes notice at you. Being aggressive as he is, KLAW raises his claw and stabs you straight through your stomach. Shoot.

    *** You have died ***

In that game you scored 0 out of a possible 0, in 3 turns.

Would you like to RESTART, RESTORE a saved game, QUIT or UNDO the last command?

>east
Please give one of the answers above.

Would you like to RESTART, RESTORE a saved game, QUIT or UNDO the last command?

>east
Please give one of the answers above.

Would you like to RESTART, RESTORE a saved game, QUIT or UNDO the last command?

* * *

>take beaker
This will be important to pass the game and so you take it.