You wake up in the base of a military lab. Can't believe you're alive, huh? From a sign outside you realize you're in Area 51. You feel as if 4 small parts of your body has been extracted right out of you but you don't know what's happened. You don't know what's going on. But what you do know is that you need to replemish what you've lost and get the hell out of this base. The sign outside Area 51 was already intimidating. Now you're in the base of the operation. The people here will do anything to kill you. It seems that everybody's out and the security cameras are off… for now. No time to poop your pants. Get out of here.

Area 51 HQ
An Interactive Fiction by Eric Tam
Release 1 / Serial number 131011 / Inform 7 build 6G60 (I6/v6.32 lib 6/12N) SD

Center of The Military Lab
You're in the center of the Military Lab. It's quite the large room. 50 meters by 50 meters, maybe? How trippy. You wonder what went on here. There's some blood stains along the floor, but nothing like a murder scene. Where should you go now? You may go in all four directions: N, S, W, and E.

You can see a S Door, Titanium Box (closed), a Green Light, an Ice Tongs and a Chemical Tray Belt here.

>w
Creature Testing Facility
You're in the Creature Testing Facility. You know that because there's a sign on the bottom that seems like it was ripped off. There's really nothing else rather than that the walls are made of spiderwebs (3x stronger than steel!) Care to go West? Curiousity could kill you.

>e
(first opening the W Door)
You can't, since the W Door leads nowhere.

>south
You can't go that way.

>east
You can't, since the W Door leads nowhere.

* * *

>w
Creature Testing Facility
You're in the Creature Testing Facility. You know that because there's a sign on the bottom that seems like it was ripped off. There's really nothing else rather than that the walls are made of spiderwebs (3x stronger than steel!) Care to go West? Curiousity could kill you.

>w
West Room
You're in the West Room. It's a little hot in this room. Spiderwebs dyed in red are encasted along the walls. A gigantic creature stands before you.

You can see KLAW and a teleporter here.

>attack klaw
KLAW screams and slashes you, and knocks you back and hitting your back against the wall of the room. You then notice that from the slash you begin to lose blood. He made a huge cut. The pain is so overwhelming you pass out. You pass out from so much loss of blood and eventually more blood spews out of you and you die.

    *** You have died ***

In that game you scored 0 out of a possible 0, in 3 turns.

Would you like to RESTART, RESTORE a saved game, QUIT or UNDO the last command?

>KLAW
That's not a verb I recognise.

>x KLAW
KLAW seems to want to kill you. Are you going to run or fight? You think he'll beat the crap out of you if you use your hands.

KLAW looks at you and roars. You're so intimidated, as he stands at a solid 15 feet. He has the skin of a T-Rex and limbs like a very athletic animal. He has the face of a ninja turtle. The claws on his fingers and feet are covered in blood. A lab suit is in his mouth. He has the teeth of a mammoth shark.

* * *

>take KLAW
I don't suppose KLAW would care for that.

>x claw
You can't see any such thing.

>c klaw
That's not a verb I recognise.

>x klaw
KLAW seems to want to kill you. Are you going to run or fight? You think he'll beat the crap out of you if you use your hands.

>east
Creature Testing Facility
You're in the Creature Testing Facility. You know that because there's a sign on the bottom that seems like it was ripped off. There's really nothing else rather than that the walls are made of spiderwebs (3x stronger than steel!) Care to go West? Curiousity could kill you.

>east
Center of The Military Lab
You're in the center of the Military Lab. It's quite the large room. 50 meters by 50 meters, maybe? How trippy. You wonder what went on here. There's some blood stains along the floor, but nothing like a murder scene. Where should you go now? You may go in all four directions: N, S, W, and E.

You can see a S Door, Titanium Box (closed), a Green Light, an Ice Tongs and a Chemical Tray Belt here.

>east
Nuclear Machinery
You're in the Nuclear Machinery Room. You don't wanna touch anything. The room is very big and filled with vehicles in a color that is quite unusual.

You can see a Table (on which is a S Key), an Alpha Tank and a Jeep here.

>take all
S Key: Taken.

>west
Center of The Military Lab
You're in the center of the Military Lab. It's quite the large room. 50 meters by 50 meters, maybe? How trippy. You wonder what went on here. There's some blood stains along the floor, but nothing like a murder scene. Where should you go now? You may go in all four directions: N, S, W, and E.

You can see a S Door, Titanium Box (closed), a Green Light, an Ice Tongs and a Chemical Tray Belt here.

>south
(first opening the S Door)
It seems to be locked.

>unlock s door with s key
You unlock the S Door.

>open s door
You open the S Door.

>south
Nuclear Weapons Room
Goodness. So many weapons. There's something on the table.

You can see a S Door, an Uranium Rifle and an Uranium Grenade here.

>take all
Uranium Rifle: Taken.
Uranium Grenade: Taken.

>north
Center of The Military Lab
You're in the center of the Military Lab. It's quite the large room. 50 meters by 50 meters, maybe? How trippy. You wonder what went on here. There's some blood stains along the floor, but nothing like a murder scene. Where should you go now? You may go in all four directions: N, S, W, and E.

You can see a S Door, Titanium Box (closed), a Green Light, an Ice Tongs and a Chemical Tray Belt here.

>west
Creature Testing Facility
You're in the Creature Testing Facility. You know that because there's a sign on the bottom that seems like it was ripped off. There's really nothing else rather than that the walls are made of spiderwebs (3x stronger than steel!) Care to go West? Curiousity could kill you.

>w
West Room
You're in the West Room. It's a little hot in this room. Spiderwebs are encasted along the walls. A gigantic creature stands before you.

You can see KLAW and a teleporter here.

>attack KLAW
You fire a bullet of Uranium at KLAW right in his stomach. He gets hurt and his mouth is open.

>attack KLAW
You fire a bullet of Uranium at KLAW right in his stomach. He gets hurt and his mouth is open.

* * *

I beg your pardon?

* * *

>x klaw
KLAW seems to want to kill you. Are you going to run or fight? You think he'll beat the crap out of you if you use your hands.

KLAW looks at you and roars. You're so intimidated, as he stands at a solid 15 feet. He has the skin of a T-Rex and limbs like a very athletic animal. He has the face of a ninja turtle. The claws on his fingers and feet are covered in blood. A lab suit is in his mouth. He has the teeth of a mammoth shark.

* * *

>attack KLAW
Violence isn't the answer to this one.

* * *

>w
Creature Testing Facility
You're in the Creature Testing Facility. You know that because there's a sign on the bottom that seems like it was ripped off. There's really nothing else rather than that the walls are made of spiderwebs (3x stronger than steel!) Care to go West? Curiousity could kill you.

>attack klaw
You can't see any such thing.

>w
West Room
You're in the West Room. A gigantic creature stands before you.

You can see KLAW and a teleporter here.

* * *

>west
Creature Testing Facility
You're in the Creature Testing Facility. You know that because there's a sign on the bottom that seems like it was ripped off. There's really nothing else rather than that the walls are made of spiderwebs (3x stronger than steel!) Care to go West? Curiousity could kill you.

>east
Center of The Military Lab
You're in the center of the Military Lab. It's quite the large room. 50 meters by 50 meters, maybe? How trippy. You wonder what went on here. There's some blood stains along the floor, but nothing like a murder scene. Where should you go now? You may go in all four directions: N, S, W, and E.

You can see a S Door, Titanium Box (closed), a Green Light, an Ice Tongs and a Chemical Tray Belt here.

>s
(first opening the S Door)
It seems to be locked.

* * *

>west
Creature Testing Facility
You're in the Creature Testing Facility. You know that because there's a sign on the bottom that seems like it was ripped off. There's really nothing else rather than that the walls are made of spiderwebs (3x stronger than steel!) Care to go West? Curiousity could kill you.

>west
West Room
You're in the West Room. It's a little hot in this room. Spiderwebs are encasted along the walls. A gigantic creature stands before you.

You can see KLAW and a teleporter here.

>attack klaw
KLAW screams and slashes you, and knocks you back and hitting your back against the wall of the room. You then notice that from the slash you begin to lose blood. He made a huge cut. The pain is so overwhelming you pass out. You pass out from so much loss of blood and eventually more blood spews out of you and you die.

    *** You have died ***

In that game you scored 0 out of a possible 0, in 3 turns.

Would you like to RESTART, RESTORE a saved game, QUIT or UNDO the last command?

I beg your pardon?

* * *

>take green light
That's fixed in place.

* * *

>take all
Titanium Box: Taken.
Ice Tongs: Taken.
Chemical Tray Belt: Taken.

The General of this base sees you and shoots you. End.

>w
Creature Testing Facility
You're in the Creature Testing Facility. You know that because there's a sign on the bottom that seems like it was ripped off. Care to go West? Curiousity could kill you.

You can see a W Door here.

The General of this base sees you and shoots you. End.

* * *

>south
You can't go that way.

>take all
Uranium Rifle: Taken.
Uranium Grenade: Taken.

>unlock s door with s key
I only understood you as far as wanting to unlock the S Door with the S Door.

* * *

>south
You can't go that way.

>s
You can't go that way.

* * *

>open titanium box
It seems to be locked.

* * *

>unlock titanium box
What do you want to unlock Titanium Box with?

>unlock titanium box with titanium keu
I only understood you as far as wanting to unlock Titanium Box with Titanium Box.

>unlock titanium box with titanium key
I only understood you as far as wanting to unlock Titanium Box with Titanium Box.

* * *

>east
Nuclear Machinery
You're in the Nuclear Machinery Room. You don't wanna touch anything. The room is very big and filled with vehicles in a color that is quite unusual.

You can see a Table (on which is a S Key), an Alpha Tank and a Jeep here.

* * *

>take all
S Key: Taken.

>x s key
A basic silvery key is on the ground. It's labeled S.

* * *

>east
Nuclear Machinery
You're in the Nuclear Machinery Room. You don't wanna touch anything. The room is very big and filled with vehicles in a color that is quite unusual.

You can see a Table (on which is a S Key), an Alpha Tank and a Jeep here.

>touch alpha tank
The Tank launches a nuclear forcefield and fires a bullet straight through you. In the afterlife you figure that they had a fingerprint scanner on those vehicles. As they say, no one is allowed on Area 51 unauthorized.

    *** You have died ***

In that game you scored 0 out of a possible 0, in 2 turns.

Would you like to RESTART, RESTORE a saved game, QUIT or UNDO the last command?

* * *

>s
(first opening the S Door)
It seems to be locked.

>w
Creature Testing Facility
You're in the Creature Testing Facility. You know that because there's a sign on the bottom that seems like it was ripped off. There's really nothing else rather than that the walls are made of spiderwebs (3x stronger than steel!) Care to go West? Curiousity could kill you.

>w
West Room
You're in the West Room. A gigantic creature stands before you.

You can see KLAW and a teleporter here.

>east
Creature Testing Facility
You're in the Creature Testing Facility. You know that because there's a sign on the bottom that seems like it was ripped off. There's really nothing else rather than that the walls are made of spiderwebs (3x stronger than steel!) Care to go West? Curiousity could kill you.

* * *

>east
Center of The Military Lab
You're in the center of the Military Lab. It's quite the large room. 50 meters by 50 meters, maybe? How trippy. You wonder what went on here. There's some blood stains along the floor, but nothing like a murder scene. Where should you go now? You may go in all four directions: N, S, W, and E.

You can see a S Door, Titanium Box (closed), a Green Light, an Ice Tongs and a Chemical Tray Belt here.

>west
Creature Testing Facility
You're in the Creature Testing Facility. You know that because there's a sign on the bottom that seems like it was ripped off. There's really nothing else rather than that the walls are made of spiderwebs (3x stronger than steel!) Care to go West? Curiousity could kill you.

You hear cold, heavy footsteps approaching your way. Doesn't sound good.

* * *

>e
Nuclear Machinery
You're in the Nuclear Machinery Room. You don't wanna touch anything. The room is very big and filled with vehicles in a color that is quite unusual. It's also quite cold in here. You hear the sound of an air conditioner from far away but it's still quite loud.

You can see a Table (on which is a S Key), an Alpha Tank and a Jeep here.

>take all
S Key: Taken.

>south
You can't go that way.

>west
Center of The Military Lab
You're in the center of the Military Lab. It's quite the large room. 50 meters by 50 meters, maybe? How trippy. You wonder what went on here. There's some blood stains along the floor, but nothing like a murder scene. Where should you go now? You may go in all four directions: N, S, W, and E.

You can see a S Door, Titanium Box (closed), a Green Light, an Ice Tongs and a Chemical Tray Belt here.

* * *

>south
(first opening the S Door)
It seems to be locked.

>north
Glassware Room
A room full of glass containers. The room is of a tinted blue. The color illuminates from the lights 20 feet above you. It looks a little messy. Maybe a disagreement went on in here?

You can see a Test Tube Rack and a Broken Glass here.

>north
North Room
You've reached the north room. It's covered with titanium walls.

You can see a N Door, an Ammo Box and Big Safe (closed) here.

>south
(first opening the N Door)
You can't, since the N Door leads nowhere.

>north
You can't go that way.

* * *

>e
Nuclear Machinery
You're in the Nuclear Machinery Room. You don't wanna touch anything. The room is very big and filled with vehicles in a color that is quite unusual. It's also quite cold in here. You hear the sound of an air conditioner from far away but it's still quite loud.

You can see a Table (on which is a S Key), an Alpha Tank and a Jeep here.

>x table
A table that seems like you CAN touch.

On the Table is a S Key.

>touch alpha tank
The Tank launches a nuclear forcefield and fires a bullet straight through you. In the afterlife you figure that they had a fingerprint scanner on those vehicles. As they say, no one is allowed on Area 51 unauthorized.

* * *

>combine blue chemical with red chemical
You can't see any such thing.

>take titanium box
Taken.

* * *

>north
Glassware Room
A room full of glass containers. The room is of a tinted blue. The color illuminates from the lights 20 feet above you. It looks a little messy. Maybe a disagreement went on in here?

You can see a N Door, a Test Tube Rack and a Broken Glass here.

>n
North Room
You've reached the north room. It's covered with titanium walls.

You can see a N Door, an Ammo Box and Big Safe (closed) here.

* * *

>north
Glassware Room
A room full of glass containers. The room is of a tinted blue. The color illuminates from the lights 20 feet above you. It looks a little messy. Maybe a disagreement went on in here?

You can see a N Door, a Test Tube Rack and a Broken Glass here.

>north
(first opening the N Door)

North Room
You've reached the north room. It's covered with titanium walls.

You can see a N Door, an Ammo Box and Big Safe (closed) here.