You wake up in the base of a military lab. Can't believe you're alive, huh? From a sign outside you realize you're in Area 51. You feel as if 4 small parts of your body has been extracted right out of you but you don't know what's happened. You don't know what's going on. But what you do know is that you need to replemish what you've lost and get the hell out of this base. The sign outside Area 51 was already intimidating. Now you're in the base of the operation. The people here will do anything to kill you. It seems that everybody's out and the security cameras are off… for now. No time to poop your pants. Get out of here.ev

Area 51 HQ
An Interactive Fiction by Eric Tam
Release 1 / Serial number 131007 / Inform 7 build 6G60 (I6/v6.32 lib 6/12N) SD

Center of The Military Lab
You're in the center of the Military Lab. It's quite the large room. You wonder what went on here. Where should you go now? You may go in all four directions: N, S, W, and E.

You can see Titanium Box (closed), a Green Light, an Ice Tongs and a Chemical Tray Belt here.

>open titanium box
It seems to be locked.

* * *

>combine blue chemical with red chemical
You can't see any such thing.

* * *

>unlock titanium box
What do you want to unlock Titanium Box with?